145 0 128 160 59 319 1
145 0 128 160 167 324 1
145 0 128 160 280 322 1
145 0 128 160 392 323 1
145 0 128 160 511 326 1
145 0 128 160 603 354 1
145 0 128 160 711 390 1
145 0 128 160 741 504 1
145 0 128 160 749 621 1
145 0 128 160 625 452 1
145 0 128 160 641 573 1
145 0 128 160 752 742 1
145 0 128 160 763 842 1
145 0 128 160 626 667 1
145 0 128 160 654 770 1
145 0 128 160 622 845 1
74 67 64 80 0 669 1
74 67 64 80 63 671 1
74 67 64 80 126 671 1
74 67 64 80 188 671 1
74 67 64 80 251 672 1